1111111111
1CCCCCCCC1
1CCCCCCCC1
1ECCCCCCP1
1111111111
