111111111111111111111111111111
100000K100001ACCCCC01000001CC1
1000M111000001MM00000D00001CC1
100110000000001111111100001CC1
1000000000C0C00000000001111CC1
11000000C0000000000000100M0001
111110000000111111100000011111
10000000000110000000000000CCC1
1P000M000111E000M000011100CCC1
111111111111111111111111111111
