111111111111111
11T1AM1C01C0001
100C0M001C1C1C1
10000000M000011
111111111111111
