################################################################################################################################################################################    
################################################################################################################################################################################    
################################################################################################################################################################################    
################################################################################################################################################################################    
################################################################################################################################################################################    
################################################################################################################################################################################    
################################################################################################################################################################################    
################################################################################################################################################################################    
################################################################################################################################################################################    
################       fffff################################################################################################################################################################             
################################################################################################################################################################################    
################################################################################################################################################################################    
################################################################################################################################################################################    
################################################################################################################################################################################    
################################################################################################################################################################################    
################################################################################################################################################################################    
################################################################################################################################################################################    
################################################################################################################################################################################    
################################################################################################################################################################################    
################################################################################################################################################################################    
################################################################################################################################################################################    
################################################################      (____(########################################################################################################          
################################################################      (____(########################################################################################################          
################################################################      (____(########################################################################################################          
################################################################      (____(########################################################################################################          
################################################################      (____(########################################################################################################          
################################################################      (____(########################################################################################################          
################################################################      (____(########################################################################################################          
################################################################      (____(########################################################################################################          
################################################################      (____(########################################################################################################          
################################################################      (____(########################################################################################################          
################################################################      (____(########################################################################################################          
################################################################      (____(########################################################################################################          
################################################################      (____(########################################################################################################          
################################################################      (____(########################################################################################################          
################################################################      (____(########################################################################################################          
################################################################      (____(########################################################################################################          
################################################################      (____(########################################################################################################          
################################################################      (____(########################################################################################################          
################################################################      (____(########################################################################################################          
################################################################      (____(########################################################################################################          
################################################################      (____(########################################################################################################          
################################################################      (____(########################################################################################################          
################################################################      (____(########################################################################################################          
################################################################      (____(########################################################################################################          
################################################################      (____(########################################################################################################          
################################################################      (____(########################################################################################################          
################################################################      (____(########################################################################################################          
################################################################      (____(########################################################################################################          
################################################################      (____(########################################################################################################          
################################################################      (____(########################################################################################################          
################################################################      (____(########################################################################################################          
################################################################      (____(########################################################################################################          
################################################################      (____(########################################################################################################          
################################################################      (____(########################################################################################################          
################################################################      (____(########################################################################################################          
################################################################      (____(########################################################################################################          
################################################################      (____(########################################################################################################          
################################################################      (____(########################################################################################################          
################################################################      (____(########################################################################################################          
################################################################      (____(########################################################################################################          
################################################################      (____(########################################################################################################          
################################################################      (____(########################################################################################################          
################################################################      (____(########################################################################################################          
################################################################      (____(########################################################################################################          
################################################################      (____(########################################################################################################          
################################################################      (____(########################################################################################################          
################################################################      (____(########################################################################################################          
################################################################      (____(########################################################################################################          
################################################################      (____(################################################################              `'::.################################         
################################################################      (____(################################################################       _______________H______________________________################           
################################################################      (____(################################################################      /\################         \################          
################################################################      (____(################################################################     / \################          \################         
################################################################      (____(################################################################    /   \################          \################        
################################################################      (____(################################################################   /     \              _########             \################       
########################################  -^-######################## (____(################################################################  /       \            /^\########             \################      
######################################## (.  )########################(____(################################################################ /         \          /  \########              \################     
######################################## ( | )########################(____(################################################################/           \________/    \________________________________\################    
########################################  ---######################## (____(################################################################ |!         |!################         |!################   
########################       _______________________________|_|______################             (____(########    .   ._, |_  .,################################################ |!         |!################         |!################   
########             ______########          (____(################################       (____(               `-._\/  .  \ /    |/_################################################ |!         |!        ______              ______           |!################   
########            { .  . }########         (____(################################       (____(######## \  _\, y | \//################################################    |!         |!       [      ]            [      ]          |!################   
########            {      }########         (____(################################       (____(             _\_.___\, \/ -.\||################################################      |!         |!       [______]            [______]          |!################   
########            {      }########         (____(################################       (____(               `7-,--.`._||  / / ,################################################   |!         |!################         |!################   
########   ______    ______########          (____(################################       (____(               /'     `-. `./ / |/_.'################################################|!         |!################         |!################   
########  {      }################ (____(################################       (____(########       l    l//################################################    |!         |!################         |!################   
########  {      }########     -^-           (____(################################       (____(########       l_    /################################################     |!         |!################         |!################   
########  {      }########    (. .)          (____(################################       (____(########       l-   l################################################      |!         |!       .---------.########         |!################   
########   ______########    /(   )\         (____(################################       (____(########       l   =l################################################      |!         |!       |!        |!########        |!################   
################               ---           (____(################################       (____(########      l      l################################################     |!         |!       |!        |!########        |!################   
______////_____////________////_________/__________|_|///________(____(_____////________________________//////########             /________(____(_///____________/////__l______/////____///////____////_____________________//////___________///__///////________________//////_///________///___ |!         |!       |!        |!########        |!_////__________///////_________________
  -    -- --    -  -      - - \         /- -    -   - --                -       \######## /         \########           / -   -  -      -   -  -         --  -     -   -         --    --       -   - - -   --       -  - -    --  -      -  -  - -  - ---    -   - --       - - -  -  -~|!.________|!______ |!        |!@_________________________|!   ---     -         -      -  -      -
------------------------------|         |---------------------------------------|######## |--------- \########        // -------------------------------------------------------------------------------------------------------------------------------------------------------------------------------------------------------------------------------------------------------------------
------------------------------|         |---------------------------------------|######## |---------______//////___________________-------------------------------------------------------------------------------------------------------------------------------------------------------------------------------------------------------------------------------------------------------------------
------------------------------|         |---------------------------------------|######## |---------########             -------------------------------------------------------------------------------------------------------------------------------------------------------------------------------------------------------------------------------------------------------------------
------------------------------|         |---------------------------------------|######## |-----------------------------------------------------------------------------------------------------------------------------------------------------------------------------------------------------------------------------------------------------------------------------------------------------------
------------------------------|         |---------------------------------------|######## |-----------------------------------------------------------------------------------------------------------------------------------------------------------------------------------------------------------------------------------------------------------------------------------------------------------
------------------------------|_________|---------------------------------------|___________________|-----------------------------------------------------------------------------------------------------------------------------------------------------------------------------------------------------------------------------------------------------------------------------------------------------------
------------------------------|~      ~ |---------------------------------------|    ~   ~~ ~  ~    |-----------------------------------------------------------------------------------------------------------------------------------------------------------------------------------------------------------------------------------------------------------------------------------------------------------
------------------------------|     ~   |---------------------------------------|     ~   ~ ~~  ~~~ |-----------------------------------------------------------------------------------------------------------------------------------------------------------------------------------------------------------------------------------------------------------------------------------------------------------
