1111111111
1CCCCCCCA1
1PCCCCC111
11CCCC1111
111MMDD111
11111DCCC1
11111CCCC1
11111MMME1
1K11111111
1111111111
