1111111111
1DDDDDDDD1
1D0000CCD1
1DP0DDDCD1
1D1111DCD1
1D1111DAD1
1D1K11DDD1
1DDDDDDDD1
1CCCCCCCD1
1DDDDDD1D1
1DKCC111D1
1DMCCC11D1
1DCMMMC1D1
1D11DDDDC1
1DDDDDDCA1
1111111111
1111111111
