1111111111
1DDDDDDDD1
1D00CCCCD1
1DP0DDDCD1
1D1111DCD1
1D1111DAD1
1D1K11DDD1
1DDDDDDDD1
1CCCCCCCC1
1DD0DDD101
1DD0DDD001
1DD0DDD001
1DDDDDD001
1DDDDDD001
1DDDDDD0E1
1111111111
