11111111111111111111
1CCCCDD00000000CCCC1
1KCCC110000000111111
11MM11110000000CCCK1
111110000MM000111111
100000001D1100011111
1P0000001CC100C01111
110CCC011C111MCCE111
111MMM11MMKK111CC011
11111111111111111111
