11111111111111111111
11PMCMMCCC111C1CCCC1
1C11MCCC11111C1MKC11
1CCCCC1D1CDC01MC1111
11CCCAM111111CCCCCM1
1CCDCCCC11C10CCCCCC1
1CCCCC1CCC11CMCCCC11
1C11CCC1CCC111CCC1M1
11CCCCCCCCC1CD11CCM1
11CCCCCCCC11CCC1MC11
11CCCCCCCC1CCCC1MC11
11111CCC1CC1CCC11MC1
11CD1CCCCC1CC1CD1C11
111CC1111DCC1DCCC111
11CCCCCCCCC1CCDCCC11
1C1CCCCCCCC11MDCCMC1
1C11CCC1CC11C1M11CC1
11CCC1CCC1C11CCCCC11
1111AC11CC1C1CC1CCC1
11111111111111111111
