111111111111111111111
1E00D0000000CC0CCCCC1
10001100CC00000CC11C1
11110000000000M111CC1
100000000M0MM11111CC1
10P0CC0011MMM11111CC1
111MM10011MMM11111CC1
1111101D1111111111CC1
1111111000KC0D00K0KC1
111111111111111111111
