11111111111111111111111
1AP00M000C101C000100M01
1110C11M10CM0000T00C001
11000M0C1110C0000CC0C01
1000C000C0000001000C011
11MC00C1MC10C10000C0101
10M01CC000C1000101C1C11
1C1CC101C0C001C0CC00001
1011C000CC0C110001C1C01
1000110M1000C001C000MC1
1C0M001100M00000010CCC1
1000C100C101C1M00100M11
100C0001010M0011010C0C1
10001000001000010001011
10101001010000100000101
1M0000000100M00M0010101
10001110000D01000M00001
1M0100M0010010000M00001
101000110M0100000010001
10010110000000M01001001
110001100110000M0001111
1E00000011000M0000M0111
11111111111111111111111
