111111111111111111111111111111
1CC1K01P10CC000C1000C100000C11
101000010C1AC00000110C101CC1C1
1C0C10M1C0010010010000M001C101
111C1101100101111C011C00011M01
111111111111111111111111111111
1C1100110C0C0C1101010C101000M1
1MCM100000C1001M1M1111001M0C11
11EM0101M10MCC10M0000000111101
111111111111111111111111111111
