11111111111
1TCCAP10MM1
1C0C0100001
1CCMC0010M1
1MC00CC0001
1C0M0C10C01
1CC0CCC00M1
11000000011
10100000101
1EC0001C0M1
11111111111
