1111111111111111111111111111111111
1AC0C1PCC00000C010C01C0M0C0C1T1M11
101CC010C0010100C01000C0CC0MC00101
1000010C1100CC0100C0M0C0CCC0C1C0C1
1CMC0000C000000100111001C000001001
111M01000000C0000C00000CC100101001
100C0000010000C0MCMCMC00C0000C0001
1C11MMCM0CM0110CC00000C1M00101C001
1E00011000000001000000101001010001
1111111111111111111111111111111111
