1111111111111111111111111111111
11PM0100000TM0C000000M000C00001
101001000C0C01C010001001CA00001
100CC00C0CC1M010M000100010M0101
100010101C0000C0M00CC0M0C00M1M1
10CM0M10010CC00011101C0MC000001
100C0100000CC0000010CC0100CC011
1100C001C10001C00M0C0C0C0000011
1EC11C0M001MC10C00C001C0100C0M1
1111111111111111111111111111111
