1111111111111111111111
1MC10D0100PD1CC0K01101
1C1MC100C0111101110111
110C1CM10M0D11111C1C01
1CC100010C00100111C111
1C0C100C01C01011000111
1MC01000C1001000DM1C01
1C000100C1010010000111
1010101111M010C0011011
1C0111C010010C110CC101
1000M0C0010M1C01010111
1CC01C010001100011CC01
111CC100000001M1010CC1
10000010CCA1C11C111111
11MM100100C010C1110001
1101CCM0M10M1CC1010111
1001001110DD0100110M11
1001010D100DDM00001001
1000010M0100001000D001
1000001000001100101M11
11E0000001100001M00001
1111111111111111111111
