11111111111
10T0C0CC001
10TECCC00C1
1CE1C11CCC1
1EC00EC00T1
101C0CCCCT1
1PC0C0C00C1
11111111111
