11111111111
1AM00CCMCC1
10CTM0C0101
10100000001
1MMC0P00C01
100CC100C01
11C0C100C11
10C0M00C001
100001C00C1
1E0C001C001
11111111111
