1111111111111111111111
1KCPM110C1001101000011
11010M0100C11M11000111
1C1C0A001001001C01C011
1C1000C1110001010C1011
1MM101C11C100100010C11
10111C00M00111MC000011
101010101M11CMCCC01001
11EC0C00110000110001C1
1111111111111111111111
