111111111
1T0C0TTC1
100C0CTT1
1T0C0CC01
1CC00TC01
1TC0CC101
1C0P0CT01
100100001
10TC0C001
1CT00C0T1
1C0T00001
1CC0CCT01
110T00TC1
1T00C00C1
10T00TC01
10100CT01
10TTTC0C1
111111111
