111111
1CA0C1
1P0C01
1E00C1
1100M1
111111
