1111111111111
10010000000C1
1000011111001
1P0011E000001
1111111111111
1111111111111
10010000000C1
1000011111001
1P0011E000001
1111111111111
1111111111111
100100M0000C1
1000011111001
1P0011E0M0001
1111111111111